2 2 2 2 2 2 2 2 2 2 2 2 2 2 2 2 2 2 2 2 2
2 2 2 2 2 2 2 2 2 2 2 2 2 2 2 2 2 2 2 2 2
2 9 1 11 30 9 1 10 1 1 1 1 1 1 1 10 1 10 1 11 2
2 0 13 0 49 0 50 0 48 49 50 47 28 29 50 0 30 0 30 0 2
2 0 14 3 1 8 49 7 1 1 10 1 1 1 1 4 1 6 1 8 2
2 0 15 28 29 0 30 0 28 29 0 50 47 30 50 48 47 0 50 0 2
2 0 16 9 1 5 49 7 1 1 4 1 1 11 49 9 1 8 48 0 2
2 0 17 0 49 30 48 0 47 31 32 33 34 0 48 0 13 0 50 0 2
2 7 1 5 49 9 1 5 47 35 36 37 38 7 1 5 14 7 1 8 2
2 0 30 50 49 0 48 30 47 39 40 41 42 0 28 29 15 0 30 0 2
2 7 1 11 49 7 1 11 47 43 44 45 46 7 1 11 16 7 1 8 2
2 0 48 0 49 0 50 0 28 29 9 1 1 8 47 0 17 0 47 0 2
2 0 13 3 1 8 30 7 1 1 8 48 30 0 50 3 1 8 30 0 2
2 0 14 50 47 0 48 0 28 29 0 30 50 0 48 50 49 0 50 0 2
2 0 15 9 1 4 1 6 1 1 4 1 1 4 1 10 1 6 1 8 2
2 0 16 0 48 49 50 0 18 20 20 20 20 20 19 0 47 0 48 0 2
2 0 17 7 1 11 47 0 25 27 27 26 27 27 21 0 48 0 49 0 2
2 3 1 5 30 3 1 5 24 23 23 23 23 23 22 3 1 4 1 5 2
2 2 2 2 2 2 2 2 2 2 2 2 2 2 2 2 2 2 2 2 2